.....#............#.....#......#.....#.......#..#...#.#..##.##.....####..#........#.......#..#...#..
....##...#...#...##.......###......###..#...#.#......##......#......##......................#......#
.##.....#.......##.#....#.#.#...#.###..#..#.##.##...##..##.#...#...#.#..###...#....###..##.........#
......#..#.#.....#..#...#..#........#..#....##.#...#.......#.....#..#.##.........#...#............#.
...#...#.#.....#...#...#............##...#....#.....#..##.#...###.#...........#.##...........##..##.
..#..#.#...####..#.###.....#...#..##....####......#....##...##..###....##....#..#.##.##.........##..
#.....#......#.#.#...##...#.....##...##..##.....#........#.......#...........##.......##.....###..##
##.......................##.#.#...#....#.#..#...#....##............#..#..#......#.#..#..#.#..##....#
..##....#..###.#.#.#......#.........#....#.....#....#....#..##..###.##.....#.#......#..#.....#...##.
##.....##......#.###....#..#.#.........#...#.#.##..#..##..#####.....#............#...#..##.#.......#
....#.#......##.#............#.#....##.#....#..#..#....#.....#.#....##......##.#.##....##...##......
....#.......##.#.##.....#....#......#.#....#.#..........##......#..#.#......##....#......##.#...#...
.#..........#...###.#.....#.#...####.#....##.#.##...#.#.....#..#........##.#...#....##.#..........#.
...........#.............#....###.#...##..#...##....................###.......#..#...#....##.....#..
.#..........#....#.#.#...........##.#.#..#.............#.#..#...#...#..............#................
...#.....#......#..#..##..##....##...#.....####.....##.#..#..##....#....#.#.....#.#...#.#...........
.......#.#.........#..........#.##.##................#.......###..#...##.#...........##.#.#.........
.....#.#..#......#..#.###.#.....#.....###.##.#...#...........#............#........##....#.####...#.
...............#.....#....#..##..........####........#.#.#..#.##.......#.#............#..#....#.....
..#.....#......##.#.#......#...#....####.....#......#........####..#.......#..#...#........#.....#.#
...#..##.......#...#...#......#........#.#..#......##.#..#...##.#.#...#.....#..#...##.#####......#..
..#.##.##...#...#...#.#.#.......#.#..........###.....##.....#...#..........#....#........##..#...#..
..#.......#...........#...........###..........##..#.....#....#.#..##.....#....###....#..#..#..#.##.
......#.#...###....#.#.........###.##.#..#..#.......#..##....#.##.#.#.#.#.....#.###....#....##.####.
##....###..........#........##.#......#.#..#...........##..#.#...#...#..................#...#.......
.#.#..#..##.....#..#.#...#..#...#.#.....#..............#..#.###.#.#....#....##......#.....#.##......
......##...##.....##...#...#......#.##...#........#.......##.......#.#.........###.......#.....##...
.#...##....#.....#...........##...#..#.#.#..#.....#.....#....#..........#..#..................##..##
..#...#....#.##......................#..#..#.##.##....#.#..#........###......#.#..#.#..##...#...#.#.
.....##.##...##.##.#.###.##........#....#.......#.#.....#.#...#.#..#.........#...##........#........
..#.......#.##...##.......#....#...#.......#.#...#..#.##........#....#.#..#....#...#............#...
..#......#......#..#..#......###..###......#................#..#.#.....#.##.....####..#....#..#.#.#.
.....#..#...##..##.....##.....#.#.###..#...#................#.###.##.##.##..#...#.#..#..........##..
#..#....#.#.....#.......##..##........##.##....#...#.....#..#.......#..##.##....####.#..........#...
.......#.....#......#.##.............##.#...#..........####..##......####.#..#.......##...#..#......
.##.......#....##.#.#..#.##..#...#.#....#......##..#..#......#....#.....#..#..#....#.....#...#..#.##
.###..........#......#......#..#...#...#..#.#..#.......#....#.#...#.....#....#...#........#.#..#....
###..#..#.......#......#..##.#.#.#......#..#.#.##............#.....#.....#...#..........#.........#.
..####.#...#.#..#.................##..#.###.....#.....#....#.....##.....#####.....#....#.#.#...#....
#..#....#..................##.#........##..............#.###.#......#.....#.......####..#.#..#...#..
#...#.#..#.###.#......#.#..#.#.....#.....#....##.#.........#....###..#.......#.#....#..#....##......
..#....#.##................#..###...#..#.#..#............####.#..........#..................#..#...#
.#...#.###..###....#......#.#....#...#.###......##..#.#.#.............##........##....##..#....##...
.........###..#.#.......#..#..#......#....#.....#.....#..#..#.....#.........###.#.........#..###..#.
.#............##.#.#..#.#..#.....#..#.....##......#....#..#...#.....##..#.#.........##.........##...
.......#.....#.##.#..#.##..#.......#.#..#...#..#....#....##.....#.....#.#........#.#....###..#..#..#
..##..##...##....##............#.....#..#..#........#.#......#...##.#.#......#...........#.#......##
.#.................####....#................#...###....#....#.#.........#..#............#...#..#.#..
#.##.#..#.#..#......#.#...#.#....#.....#....#...#...#....###..#......#...........#....#.#.....#.....
..#.#.#..............#......#.#...#..##.......##..#...#......#..#..##.#.#.##....##..........#....###
.......#........##........#......##....#..#.####....#.......#........#.#........#......#.##..#......
...#.##...###.....##...#..##.....................#.#.##.#.#....#..#.#.......###....###..#####....#..
.#....#.##.....##..#..#....#....##.#......#...#.....###...#....#......#...###..#..#.#.....##....#...
#.#........#.......##.#....##..#....#..#...........#.#..##.....#.#.......##..#..#...#.#..#...#.#.###
.#...##.....###.......###.....##..........#.........###..###.....#..#.#...#.........##.#...#.#..#...
#.#..#.....#.#.....##..........##...#...###...#....##.................#..........#..#..........#....
..#......#..#...............#....##....#.....##......##..#..#....#..#................#.........#....
.#..........#.....#.#...#.....#.##...##.#.##..#..#.#..#.#.#....##.......#.#.......###.#..##.....#..#
##...#..##..#...#...#............####....##.#....#.....##..#.#...#..#.....#..##....#.........###....
........#....#..#...#.....#...........#...#....#.#.#.#....#...#........##...............#.......#...
.#........###...##.##.#..#..#.#.#.###..#..............#......#.#...#....##..#....#...#..####.....#.#
......#........##.#.#.........#.#.#...........##.#.#.#..........#.#.##....##..##.........#....#.....
##.#.#.........#..#.#......###.##....#.....##.......#...##.........#.#........#.##.#...##.....#..#..
...#.....#...............#...#.....#....##...#..#..#...#..##..#......#.....#....#..#.....#.#.#.#....
#...........#...#...#......#..#...#.....#..#........##.#.#..#.........#..##...#......#.#.....#..#...
...#.#.........##...#..#.............#.##.####.#.#.....##.#..#........#.#..##......##...##.#.....##.
......##.#.............##.......##..#..###..#.........#.##...##..###............#........#..........
..#.#...#...##......#..#...##............#..........##.#......#.....##.......#....#...#...#..#....#.
##.....#....#.......#..#.##............#.....##....#.....#..#.#.#......#...##.#...#.#...............
...#...#........#...#....#...#...##...#..##......##........#...#...............#..#....###.....##...
..........##..#.#.#...##....##........##.#.........##..#.#...##..#.#.#.....##..#.#.......#.......##.
...#...........##.........#.............#...#.....#..#..#..#..#.....#...#.....#..#...##.#......#.#..
....#...##...##.....#.#...#..#.##......C........#..###.#.#..#...#..###............#.......#..#.#..#.
#.#......##.#....#...#..........#...#.......#...#...#.#..#..#.......#.#.##................#..#.#....
#.#..........#.#...#....#.#..#....##..##..........#....#.#....#..#...#..#.....#...#.......#..#....##
....#.#.##.#..#.#..............##.........#.#....#...........#.###.##.##.#..##.#.#..##..........#.#.
...#.#....#.#...#....#.#....#..#...#....#...#.#....#.###.##.#.....#.#...#.#.#...#....#..#..#...#....
.....#...#..#..#..........#.#..#........#...#....#....#...##....##.###................#....#...#....
..##...#..##.#...#......#.#..#....#.#.........##....#.......#..##....#..#.#...#...............###...
.##..........#.#...#.....#..#..##.......#..#..#.......#.##........###....#........#...#....#...#.#.#
....#....#.........##....#....#.#...#...........#......#....#.....##..#.......#.#..........#..##....
#...#...#.....###................##..#.#.##........#............#.##..#....#..##..#.#..#.....#......
###....#........#...........##.#....##.#...........##..#.......#....##...##.....#..#.#...#..#.#.....
....#.#.#.##.....#...##.#....#....##.#...........#...#.....#....#.#.###.#............#.........#..#.
#..#......#.....#.......##....#...#...#..............#.#.......#.#....##.......##.#..#.#......##...#
#..##...###.###...#.#.#....#...##......##........#..##...#..##......###....#.........#...##.......#.
..#....#....#...#....#...###...###.........###..........#....................#.##.#..#..#.........#.
....#.....#.#.....##.........#.......#..#####..#...##.....#..###...#.###.#..###......##.......#...#.
.##.................##.#..##...#..#.#....#........#...#.#...#....#..#.##.##....#...#...#..#....#.#..
...#....##...#.............#.....#.##..#........#..###.##....####..#.......###...#....#.##....#..###
.#..#....#......##..#..#............##.#.#..#..#.#..##..#...#......#.#..#........#..##..#..##....#..
.##...##...#......#........#..#....#.....#..#..#........###...#......#..#..#...##.#....##.........##
..#..#...#....#..#.....##..#.##.##.....##......#.....#......#.......#...##..........#...#...#...#..#
#.....#......#.....#...#....#..#....#..##.##....##.....##.#.#.#.###...#..#......##..##.....##.......
#.#....#.#......###..#......#....##......#.#.......#....#.#.....##..#...#..###.##..#.#...#..........
..#...........#..#....#.....#...#..##.#.#................##...#..###...#...#..#...###..#.......#....
....#...##....##......#.....#....##.#..#....#........#.###..#......#.#...#.....#..#.#..............#
..........#..#.........#....#.##.......#.#..#....#........#..##.#.......#............##...#.......#.
..#.#...#..#.##..#...##....#.#.#...##.....#.#.##...#..#..#.#.##.#.#.......#.......##....#....#.#....
............#.......#...#..##...#.#.#...#..#....#.#...#...#.#...#..#..#......#..#..#.....#..#.#..#.#
